############################
#............##............#
#.####.#####.##.#####.####.#
#.####.#####.##.#####.####.#
#*..##........C.......##..*#
###.##.##.########.##.##.###
###.##.##.########.##.##.###
#......##....##....##......#
#.##########.##.##########.#
#.##########.##.##########.#
#....G....G......G....G....#
############################